9 13
-------------
-S-H---S-----
-C-----------
-------------
-V-C---V-----
-------------
-------C-----
-S-H---S--P--
-------------
